11
10,1
10,9
+++++++++++
+OOOOO+OOO+
+++++O+O+O+
+OOOOO+O+O+
+O+++++O+O+
+OOOOOOO+O+
+O+O+++++O+
+O+O+O+OOO+
+++O+O+O+++
+OOOOO+OOO+
+S+++++++E+