41
0,1
40,59
+S+++++++++++++++++++++++++++++++++++++++++++++++++++++++++++
+OOOOO+OOOOO+OOO+OOOOOOO+OOO+OOOOOOOOOOOOO+OOOOOOOOOOOOOOO+O+
+O+O+O+O+++++O+++++O+O+++++O+++++O+++++++O+O+O+++++O+++++O+O+
+O+O+O+OOO+OOOOO+OOO+OOOOO+OOO+OOOOOOOOO+OOO+OOOOO+OOOOO+OOO+
+O+O+O+++O+++++O+++O+O+++O+O+++++++O+O+++O+O+++++++++++++++++
+O+O+O+OOO+OOOOOOOOO+O+OOOOO+OOO+OOO+O+OOO+O+OOOOO+OOO+OOOOO+
+O+O+++O+++++O+O+++++++++++++++O+O+++++++++O+++O+O+++O+O+++++
+O+OOOOO+OOOOO+OOO+OOO+OOO+OOOOO+OOOOO+OOOOO+O+O+OOO+OOOOOOO+
+++++O+++++O+++O+++++O+++O+O+++O+++O+O+++O+++O+++O+++O+O+O+++
+OOO+OOOOOOOOO+O+OOOOOOOOO+O+OOOOO+O+O+O+OOO+OOO+O+O+O+O+OOO+
+++O+++++O+++O+++++O+++O+++++O+++O+O+++O+O+++++O+O+O+++++O+O+
+OOO+OOOOO+O+OOOOO+O+O+O+OOOOOOO+OOO+O+O+OOOOOOOOO+O+O+OOO+O+
+O+O+++++O+O+O+++++++O+O+O+O+++O+O+++O+O+++++++O+++O+O+O+++++
+O+O+O+OOO+OOOOO+OOOOOOOOO+OOO+O+O+OOOOOOOOOOO+OOO+OOOOO+OOO+
+O+++O+O+O+O+++O+O+++++O+O+++++O+++++++++++++O+++++O+++O+++O+
+OOOOOOO+O+O+O+OOO+O+OOO+O+OOOOO+O+O+OOOOOOO+O+OOOOO+OOOOOOO+
+O+++O+O+++++O+++O+O+++O+O+++O+O+O+O+++O+++O+O+O+O+O+++++++O+
+OOO+O+O+OOOOO+O+O+O+OOO+O+O+O+OOOOOOOOOOO+OOOOO+O+O+O+O+OOO+
+O+++O+++O+++++O+O+O+O+++++O+++++O+++++O+++++++++++O+O+O+++++
+O+O+OOO+OOOOOOO+O+OOOOOOO+OOOOOOOOO+O+OOO+OOO+O+OOOOOOO+OOO+
+O+O+++O+O+++++O+++++++++++++++O+O+++O+++O+O+O+O+++++O+O+++O+
+OOO+OOO+OOO+OOOOO+OOOOO+O+OOOOO+O+OOOOOOOOO+O+OOO+OOO+O+OOO+
+O+++++++O+O+++O+++++++O+O+O+O+++O+O+O+++++O+O+O+++O+O+O+++O+
+O+OOO+O+O+O+O+OOOOO+OOO+OOO+OOO+O+O+O+OOOOO+OOO+O+O+O+OOOOO+
+O+O+++O+O+++O+O+++++O+O+O+++++++++++++++++O+O+O+O+O+O+++O+++
+O+OOO+OOO+OOOOOOO+O+O+O+O+OOOOOOOOOOO+OOOOO+O+OOO+O+OOO+O+O+
+++++O+++O+++O+++O+O+++O+++++++++O+++O+O+++++++O+O+++O+O+++O+
+OOOOOOOOO+O+O+O+OOO+OOOOO+O+O+OOOOO+OOO+O+O+O+O+O+OOO+O+OOO+
+O+O+++O+++O+++O+O+O+O+++++O+O+++O+++++O+O+O+O+++++O+O+++O+++
+O+OOO+O+OOO+O+O+O+O+OOOOO+O+OOOOO+OOO+OOOOO+O+OOOOO+OOOOOOO+
+O+++++++++O+O+O+O+++++++O+O+O+O+O+O+++O+++++O+++++O+O+O+++O+
+O+OOOOO+OOOOOOO+OOOOO+OOO+O+O+O+OOO+O+OOOOOOOOO+OOO+O+OOO+O+
+++O+++++++++O+++O+O+O+++O+O+O+++++++O+O+++++O+O+O+++O+O+++O+
+OOO+OOOOOOO+OOOOO+O+O+OOOOO+O+OOO+OOOOO+OOO+O+O+OOO+O+O+OOO+
+O+++++O+++O+++++O+++O+++O+++++O+O+++++O+++O+++++++++++O+++++
+O+OOOOO+OOOOO+OOOOO+OOOOOOOOOOO+OOOOOOO+OOO+OOO+O+OOOOOOOOO+
+O+++O+++++++O+++O+++++++++++O+++++++O+O+O+++O+++O+O+++++O+++
+OOOOOOO+O+OOO+O+OOO+OOOOO+OOO+O+OOOOO+OOOOOOO+O+OOOOOOO+OOO+
+++++++O+O+++O+O+O+++O+++O+++O+O+++O+O+++++O+++O+O+O+O+++O+++
+OOOOOOO+OOOOOOOOOOOOO+OOO+OOOOO+OOO+OOO+OOOOO+OOO+O+O+OOOOO+
+++++++++++++++++++++++++++++++++++++++++++++++++++++++++++E+