21
0,79
18,0
+++++++++++++++++++++++++++++++++++++++++++++++++++++++++++++++++++++++++++++++S+
+OOO+OOOOOOOOO+O+O+OOO+O+OOOOOOO+O+OOO+OOO+OOOOOOO+OOOOOOOOOOOOOOO+OOOOOOOOOOO+O+
+O+O+O+O+++++++O+O+O+O+O+O+O+O+O+O+++O+++O+O+++++O+++++O+O+++++++++O+O+O+++O+++O+
+O+O+O+OOOOOOO+O+O+O+OOO+O+O+O+OOO+OOOOOOOOO+OOO+OOO+OOO+O+O+OOO+O+O+O+O+O+O+O+O+
+O+O+++++O+O+O+O+O+++O+++O+++O+O+++O+++O+++++O+O+++O+O+++++O+O+++O+++++++O+O+O+O+
+O+O+O+O+O+O+OOOOO+OOOOOOO+O+O+OOO+O+OOOOOOO+O+OOOOOOOOO+OOOOOOO+OOO+OOOOOOOOO+O+
+++O+O+O+O+++++++++O+O+++++O+O+++O+++++O+O+++O+O+++++++++++O+O+O+O+++++++O+O+++O+
+OOOOO+OOO+O+OOOOOOO+OOO+OOO+O+O+OOO+OOO+O+O+O+O+OOOOOOO+OOO+O+OOOOOOO+OOO+O+O+O+
+++++O+O+++O+O+O+O+++O+O+++O+++O+O+O+++O+++O+++O+++O+++O+++O+O+O+++++O+++++O+O+O+
+OOOOO+OOOOO+O+O+O+O+O+O+O+OOOOOOO+OOO+OOOOOOO+OOOOOOO+O+O+O+O+O+O+O+O+OOOOOOOOO+
+O+++++++++O+O+++O+O+O+++O+++++O+++O+++O+O+++O+++O+++O+++O+O+O+O+O+O+O+O+++O+++O+
+OOOOOOO+OOO+O+OOOOO+OOO+O+OOO+O+OOOOO+O+O+OOOOO+O+OOOOO+O+O+O+O+OOOOOOO+OOOOO+O+
+O+O+O+O+++O+O+++++O+O+O+O+O+++O+O+O+O+++++O+++++++O+++O+O+O+O+++++++++++++O+++O+
+O+O+O+O+OOO+OOO+OOO+O+OOO+OOOOO+O+O+O+O+O+OOOOO+OOOOO+OOOOO+O+OOOOOOOOO+O+O+OOO+
+O+O+O+++++O+++O+++O+O+O+O+++O+O+O+O+++O+O+++++O+++++O+++O+O+++O+++++++O+O+++O+++
+O+O+OOOOO+O+O+O+O+O+O+O+O+O+O+O+O+OOOOO+OOOOOOOOO+OOO+OOO+OOOOO+OOO+OOOOO+OOOOO+
+O+++++O+O+O+O+O+O+O+++++O+O+O+O+++O+++++++O+++O+++O+O+++++++++O+O+++++++++O+++O+
+OOO+O+O+OOOOO+OOO+OOO+OOOOO+O+OOO+O+OOOOOOOOO+O+OOO+OOOOOOOOO+OOO+OOO+OOOOO+OOO+
EO+O+O+O+++O+O+O+O+O+++++++O+O+++++++O+++++++++++O+O+++++O+O+++O+++O+O+O+++++++O+
+O+O+OOO+OOO+OOO+O+O+OOOOOOO+OOOOOOOOOOOOOOOOOOO+O+O+OOOOO+OOO+OOOOO+O+O+OOOOOOO+
+++++++++++++++++++++++++++++++++++++++++++++++++++++++++++++++++++++++++++++++++